R 800 600
NO ./images/turtle_blue.xpm
SO ./images/turtle_green.xpm
WE ./images/turtle_purple.xpm
EA ./images/turtle_red.xpm
S ./images/gumba_512.xpm
C 135,206,235
F 182,209,212

1111111111111111111111111
1E00000000200000000000001
1000000000000000001111111
100000000000000001001
10000000000000000111
1000000000000000011111111
1000000000000000000000001 
100000200011000001110111111111111
11110111111111011100000000001
11110111111111011101010010001
11000000110101011100000010001
10002000002000001100000010001
10000000000000001101010010001
1100000111010101111101111000111
11110111 1110101 101111010001
11111111 1111111 111111111111